1111111111111111111111
100000000000000000ECP1
1000000000000000000001
1000000000000000000001
1000000000000000000001
1000000000000000000001
1000000000000000000001
1000000000000000000001
1000000000000000000001
1000000000000000000001
1000000000000000000001
100000000000N000000001
1111111111111111111111