1111111111111111
100E00001N000001
1000011CCCC10001
1000000000000001
1000010101000001
100001P001000011
1000010000000011
100N000000000001
1000000CCCC00001
1000N00000000001
1111111111111111