1111111
1111111
1111001
111E001
11P00C1
1111111