1111111111111111111111
100000000000000000ECP1
1000000000000000000001
1000000000000000000001
1000NNN0NNNN0NNNN00001
10000N00N0000N00N00001
10000N00N0NN0N00N00001
10000N00N00N0N00N00001
1000NNN0NNNN0NNNN00001
1000000000000000000001
1000000000000000000001
1000000000000000000001
100000000000N000000001
1111111111111111111111