1111111111111111
100E00001N000001
1000011000010001
100000000CCCC001
100001P101000001
1000010001000011
1000010000000011
100N000000000001
1000000000000001
1000N00000000001
100000001N000001
1111111111111111