111111111
10PC0C011
111111111
10000E111
111111111