111111111111111111
100C0000C000C000E1
1C0N00001110000001
1000C000001100C001
10P01110000C000001
100NC000C0000C0001
111111111111111111